**************************************************
*    *********************************************
**** *********************************************
**** *********************************************
**** *********************************************
**** *********************************************
**** *********************************************
**** *********************************************
****               *******************************
**** ************* *******************************
**** ************* *******************************
**** ************* *******************************
**** *************         ***********************
**** *********************************************
**** *********************************************
****    ******************************************
**** *********************************************
**** *********************************************
**** *********************************************
**** *********************************************
**** *********************************************
**** *********************************************
**** *********************************************
*                                  ***************
**** ******* ********************* ***************
**** ******* ********************* ***************
****   ***** ********************* ***************
************ ********************* ***************
************ ********************* ***************
************ ********************* ***************
************ ********************* ***************
************ *********************       *********
************ ********************* ***** *********
************              ******** ***** *********
************************ ********* ***** *********
************************ ********* ***** *********
********************     ********* ***** *********
******************** *** *************** *********
******************** *** *********       *********
************************ ********* ***************
***********************                          *
************************************************ *
************************************************ *
************************************************  
**************************************************
**************************************************
**************************************************
**************************************************
**************************************************
**************************************************